Achillea millefolium - Schafgarbe
Aconitum napellus - Eisenhut
Aesculus hippocastanum - Rosskastanie
Agnus castus - Mönchspfeffer
Allium cepa - Küchenzwiebel
Allium sativum - Knoblauch
Amygdala amara - Bittere Mandel
Angelica archangelica - Engelwurz
Aralia racemosa - Amerikanische Narde
Arnica montana - Bergarnika
Artemisia absinthium - Wermut
Artemisia vulgaris - Beifuß 
Avena sativa - Hafer
Belladonna atropa - Tollkirsche
Bellis perennis - Gänseblümchen
Betula alba - Weiße Birke
Bryonia alba - Zaunrübe
Calendula officinalis - Ringelblume
Cardiospermum halicacabum - Ballonrebe
Carduus marianus - Mariendistel
Chelidonium majus - Schöllkraut
China - Chinarindenbaum
Cimicifuga racemosa - Traubensilberkerze
Convallaria majalis - Maiglöckchen
Crataegus - Weißdorn
Cynara scolymus - Artischocke
Drosera - Sonnentau
Echinacea - Sonnenhut
Echinacea pallida - Blasser Sonnenhut
Eleutherococcus senticosus - Taigawurzel
Ephedra - Meerträubel
Equisetum arvense - Schachtelhalm
Eupatorium perfoliatum - Wasserhanf
Euphrasia - Augentrost
Fagopyrum esculentum - Buchweizen
Fucus - Tang
Galium odoratum - Waldmeister
Gelsemium sempervirens - Wilder Jasmin
Gentiana lutea - Enzian
Ginkgo biloba - Ginkobaum
Humulus lupulus - Hopfen
Hydrastis canadensis - Kanadische Gelbwurz
Hypericum perforatum - Johanniskraut 
Iris - Schwertlilie
Lycopodium clavatum - Bärlapp
Malva silvestris - Wilde Malve
Mandragora officinalis - Alraune
Matricaria chamomilla - Echte Kamille
Melilotus - Steinklee
Melissa officinalis - Zitronenmelisse
Mentha piperita - Pfefferminze
Nux vomica - Brechnuss
Okoubaka aubrevillei - Okoubaka
Phytolacca decandra - Amerikanische Kermesbeere
Piper methysticum - Kava-Kava
Propolis - Bienenkittharz
Pulsatilla - Kuhschelle
Rauwolfia serpentina - Indische Schlangenwurzel
Rhus toxicodendron - Giftsumach
Rosmarinus officinalis - Rosmarin
Ruta graveolens - Weinraute
Sabal serrulatum - Sägepalme
Salvia officinalis - Echter Salbei
Sambucus nigra - Schwarzer Holunder
Sarsaparilla - Sarsaparille
Solidago virgaurea - Echte Goldrute
Symphytum officinale - Beinwell
Taraxacum officinale - Löwenzahn
Thuja occidentalis - Lebensbaum
Thymus vulgaris - Thymian 
Tropaeolum majus - Große Kapuzinerkresse
Urtica - Brennessel
Vaccinium myrtillus - Heidelbeere
Valeriana officinalis - Baldrian
Viola tricolor - Wildes Stiefmütterchen
Viscum album - Mistel
Yohimbé - Yohimbe
Echinacea purpurea - Roter Sonnenhut
Azadirachta indica - Niem
Dioscorea villosa - Wilder Yams
Taxus baccata - Eibe
Juniperus communis - Wacholder
Catharanthus roseus - Madagaskar-Immergrün
Podophyllum peltatum - Maiapfel
Vinca minor - Kleines Immergrün
Tilia - Linde
Pilocarpus - Jaborandi
Quercus - Eiche
Nicotiana tabacum – Tabak
Coffea arabica - Arabica-Kaffee
Datura stramonium - Stechapfel
Nuphar luteum – Gelbe Teichrose
Solanum dulcamara - Bittersüßer Nachtschatten
Lobelia inflata - Lobelienkraut
Iberis amara - Bittere Schleifenblume
Alchemilla vulgaris - Frauenmantel
Primula veris - Echte Schlüsselblume
Lycopus virginicus - Virginischer Wolfsfuss
Pareira brava - Grieswurz
Zingiber officinale - Ingwer
Curcuma zanthorrhiza - Javanische Gelbwurz
Imperatoria ostruthium - Meisterwurz
Kalmia latifolia - Breitblättrige Lorbeerrose
Hyoscyamus niger - Schwarzes Bilsenkraut
Nigella sativa - Echter Schwarzkümmel
Brassica nigra - Schwarzer Senf
Sinapis alba - Weißer Senf
Veratrum album - Weißer Germer
Abies alba - Weißtanne
Pulmonaria officinalis - Echtes Lungenkraut
Eucalyptus globulus - Eukalyptus
Salix - Weide
Hedera helix - Efeu
Arctium lappa - Große Klette
Vincetoxicum hirundinaria – Weiße Schwalbenwurz
